20 20
####################
#                  #
#                  #
#                  #
#                  #
#                  #
#                  #
# <                #
#     @            #
#                  #
#                  #
#   ###            #
#     #####        #
#####     ###      #
#   #####          #
#       #####      #
#               !  #
#                  #
#                  #
####################