25 25
#########################
#                       #
#                       #
#                       #
#                       #
#                       #
#              !        #
#                       #
#                       #
#                       #
#                       #
#                       #
#                       #
#       @               #
#                       #
#                       #
#                       #
#                       #
#                       #
#                       #
#                       #
#                       #
#                       #
#                       #
#########################