25 25
#########################
#              #        #
#              #    !   #
#              #        #
#              ##   #####
#                       #
#              !        #
#                       #
#                       #
#                       #
#         #   #         #
###########   ###########
#         #   #         #
#       @               #
#                       #
#                       #
#                       #
#                       #
#                       #
#                       #
#                       #
#                       #
#                       #
#                       #
#########################