25 25
#########################
#              #        #
#              #        #
#       !      #        #
#              ##   #####
#                       #
#                       #
#                       #
#                 !     #
#                       #
#         #   #         #
###########   ###########
#         #   #         #
#       @               #
#                       #
#                       #
#                       #
#                       #
#                       #
#                       #
#             ###       #
#               #       #
#               #       #
#               #       #
#########################