25 25
#########################
#              #        #
#              #        #
#              #    >   #
#      !       #        #
#              #        #
#              #    #####
#                       #
#                 !     #
#                       #
#         #   #         #
###########   ###########
#         #   #         #
#                       #
#                  #    #
#      @                #
#                       #
###            #        #
#                       #
#                       #
#             ###       #
#      #        #       #
#               #       #
#               #       #
#########################