25 25
#########################
#              #        #
#              #        #
#              #        #
#      !       ##   #####
#                       #
#                       #
#                       #
#                 !     #
#                       #
#         #   #         #
###########   ###########
#         #   #         #
#                       #
#                  #    #
#      @                #
#                       #
###            #        #
#                   !   #
#                       #
#             ###       #
#      #        #       #
#               #       #
#               #       #
#########################