10 10
##########
#    ,   #
#<     > #
# ,   ,  #
#        #
#   @    #
#   , ,  #
#        #
#  ,     #
##########