10 10
##########
#    ,   #
#        #
# ,   ,  #
#        #
#   @    #
#   , ,  #
#<       #
#  ,   > #
##### ####