10 10
##   #####
#    ,   #
         #
  , @    #
         #
#        #
#     ,  #
#   !    #
#        #
##########