10 10
##########
#    ,   #
#        #
# , @    #
#        #
#        #
#     ,  #
#   !    #
#        #
##########